R 640 480

NO textures/bluestone.xpm

 SO textures/colorstone.xpm
 WE textures/eagle.xpm
EA textures/greystone.xpm
S sprite/Tree1.xpm

C   0,120,131 

F       0,170,58

   1111111111111111111111111
  100000000000000000000001
1100000000000000000000001
100000000001000000000001
100000000000100000000001
1000000000000000000000001
100000000000000000000001
100000000000000000000001111111
100000000000000000000000000001
100000N00000000000000000000111
1000000000000200000000011111
100000000000000000000001
100000000000000000000001        
100000000000000000000001
100000000000000000000001      
100000000000000000000001
100000000000000000000001
100000000000000000000001
100000000000000000000001
100000000000000000000001
100000000000000000000001
100000000000000000000001
100000000000001000000001
100000000000001000000001
11111111111111 111111111