R 640 480 

NO textures/bluestone.xpm
SO textures/colorstone.xpm
WE textures/eagle.xpm
EA textures/greystone.xpm

S sprite/Tree1.xpm

F       0,170,58
C 106,170,221


   11111111111111111111111
  100000000000000000000001
1100000000000000000000001
100000000000000000000001
100000000000000000000001
1000000000000000000000001
100000000000020000000001
100000000000020000000001
10000W000000020000000011111111
1000000000000000000000000001
1000000000000200000000011111
100000000000000000000001
100000000000020000000001
100000000000000000000001
100000000000000000000001
100000000000000000000001
100000000000000000000001
100000000000000000000001
100000000000000000000001
100000000000000000000001
100000000000000000000001
100000000000000000000001
100000000000000000000001
100000000000000000000001
111111111111111111111111