R 640 480 

NO ../textures/bluestone.xpm
SO ../textures/colorstone.xpm
WE ../textures/eagle.xpm
EA ../textures/greystone.xpm

F   139,0,139 
C  255,255,0 
S ../sprite/Tree1.xpm


11111111111111111111111111111111    
11000000000000000000000000000111111
11000000000000000000000000000011    
110000S00000000000000200000000111   
11000000000000000000000000000011    
11000000000000000000000000000011111
11000000000000200000000000000011
1100000200000202000000000000011
11000000000000000000100000000011
1100000000000111000100000000011
11000000000001000100000000000011
1100000000111000110000000000011
11000000000000000000000000000011
11000000000011010110000000000011
11000000000001000100100000000011
11000000001000000110100000000011
11000000000000000000000000000011
11000000000000000000000000000011
11000000000000000000020000000011
11000000000000000000000000000011
11000000000000000000000000000111
11000000000000000000000000000011
10000000000000100000000000000011
10000000000000000000000000000011
10000000111111111111111111111111
100000001
10000001
10000001
10000001
1000001
10000001
1000001
10000001
11111111
