R 10009 23442

NO textures/bluestone.xpm 
SO textures/colorstone.xpm
WE textures/eagle.xpm
EA textures/greystone.xpm 

S sprite/wq.xpm 

C      222,187,0  
F    0,241,152     

          1111111111111111111111111
          10000000001100000000000011
          100000000000000000100000001
          10000000000000000120000011
         11011002001110020000000001
        10000000000000000000N00011
111111111011000001110000000000001
100000000011000001110111111111111
11110111111111011100000000001
11110111111111011101010010001           
11000000110101011100000010001          
100000000000000011000000012001          
100000000000000000010100100001
1100000111010101111101111200111
11110111 1110101 101111010001
11111111 111111 111111111111